# lvlwidth 21
# lvlheight 15
# bgcolor 0 0 0
# edgelightcolor 0 0 255
# edgeshadowcolor 0 0 255
# fillcolor 0 0 0
# pelletcolor 255 255 255
# fruittype 1

# startleveldata
0 0 0 0 0 0 0 0 0 0 0 0 0 0 0 0 0 0 0 0 0 
107 100 100 112 21 111 100 100 100 100 100 100 100 100 100 112 21 111 100 100 108 
101 0 0 30 0 30 0 0 0 0 4 0 0 0 0 30 0 30 0 0 101 
101 0 113 0 113 0 111 100 100 100 100 100 100 100 112 0 113 0 113 0 101 
101 0 101 0 101 0 2 2 2 2 2 2 2 2 2 0 101 0 101 0 101 
110 0 110 0 110 0 111 100 100 100 100 100 100 100 112 0 110 0 110 0 110 
20 0 0 0 0 0 2 2 2 2 2 2 2 2 2 0 0 0 0 0 20 
113 0 113 0 113 0 111 100 100 100 100 100 100 100 112 0 113 0 113 0 113 
101 0 101 0 101 0 0 0 0 0 0 0 0 0 0 0 101 0 101 0 101 
101 0 101 0 101 0 107 100 100 100 100 100 100 100 108 0 101 0 101 0 101 
101 0 101 0 101 0 101 0 0 0 10 0 0 0 101 0 101 0 101 0 101 
101 0 110 0 110 0 110 0 107 112 1 111 108 0 110 0 110 0 110 0 101 
101 0 0 30 0 0 0 0 101 11 12 13 101 0 0 0 0 30 0 0 101 
105 100 100 112 21 111 100 100 130 100 100 100 130 100 100 112 21 111 100 100 106 
0 0 0 0 0 0 0 0 0 0 0 0 0 0 0 0 0 0 0 0 0 
# endleveldata

# sprites
nothing: 13 30 0 0 0 0 0 0 
nothing: 13 4 0 0 0 0 0 0 
